######################################################################
#                                                                    #
#                                                                    #
#                                                                    #
#                         #################                          #
#                         ########   # #  #                          #
#                         ########        #                          #
#                         ########   # #  #                          #
#                         ##              #                          #
#                         ##  ####   # #  #                          #
#                         ##  ####        #                          #
#                         ##  ####   # #  #                          #
#                         #  #####        #                          #
#                         #      #        #                          #
#                         #  ##############                          #
#                         ##   ############                          #
#                         ###  # #### #####                          #
#                         ##   # #### #####                          #
#                         ## ### #### #####                          #
#                         ##              #                          #
#                         ###             #                          #
#                         ####            #                          #
#                         #################                          #
#                                                                    #
#                                                                    #
######################################################################
#                                                                    #
######################################################################