######################################################################
#                                                                    #
#                                                                    #
#                                                                    #
#                         #################                          #
#                         #         #######                          #
#                         #   ###   #######                          #
#                         #   ##    #######                          #
#                         # O ##    #######                          #
#                         ######     ######                          #
#                         ## #        #####                          #
#                         ##          #####                          #
#                         ##             ##                          #
#                         ##             ##                          #
#                         ##             ##                          #
#                         ##    #   #    ##                          #
#                         ###########  ####                          #
#                         #               #                          #
#                         #H @         ####                          #
#                         ##           ####                          #
#                         ###H#############                          #
#                                                                    #
#                                                                    #
#                                                                    #
#                                                                    #
######################################################################
#                                                                    #
######################################################################