######################################################################
#       #####################################################        #
#       #          # ######   ### ### ### # # ### ### ##   ##        #
#       # ######## # #                                   # ##        #
#       #          # ### ### ############## ############## ##        #
#       # ######## # #   # # #@ @ @ @ @ @ # # # # # #       #        #
#       #          # # # # # # @ @ @ @ @ @# # # # # # ##### #        #
#       ##   ### #     # # # #@ @ @ @ @ @ # # # # # # ##    #        #
#       ####  ## # ####### ### @ @ @ @ @ @# # # # # # ## ####        #
#       #  ## #######           @ @ @ @ @ # # # # # # ##    #        #
#       ##  #  #      ###################             ## ## #        #
#       #  ### ###### ##        ##   ###### ###########   ###        #
#       ##        O## #          # #   ####   ####### # #  ##        #
#       #  ##H######  ### #### ### ###    ### ####### # ##  #        #
#       #  ## #      ####    #       # ## #         # #  ## #        #
#       #  ## ###### #    #### ### ### #  ## ######## ##    #        #
#       ##  # #      # ####  #     #   # ### ######## ### ###        #
#       #  ## ###### # #    ######## # #           #       ##        #
#       ##  #        # # # ### #   # # # ########### ########        #
#       #  ##  # ##### # # #   # #   # #                  ###        #
#       ##     #         #   #   ######### ## ## ## #########        #
#       #####################################################        #
#                                                                    #
#                                                                    #
#                                                                    #
######################################################################
#                                                                    #
######################################################################