######################################################################
#                                                                    #
#                                                                    #
#                                                                    #
#                         #################                          #
#                         ########   #V#  #                          #
#                         ########>       #                          #
#                         ########   # #  #                          #
#                         ##              #                          #
#                         ##  ####   # #  #                          #
#                         ##  ####>       #                          #
#                         ##  ####   # #  #                          #
#                         #  #####      O #                          #
#                         #     <#        #                          #
#                         #  ##############                          #
#                         ##   ############                          #
#                         ###  #V####V#####                          #
#                         ##   # #### #####                          #
#                         ## ### #### #####                          #
#                         ##              #                          #
#                         ###             #                          #
#                         ####            #                          #
#                         #################                          #
#                                                                    #
#                                                                    #
######################################################################
#                                                                    #
######################################################################